//MAP CONVERTED BY dmm2tgm.py THIS HEADER COMMENT PREVENTS RECONVERSION, DO NOT REMOVE
"ad" = (
/obj/effect/turf_decal/box/white/corners,
/obj/effect/turf_decal/loading_area/white{
	dir = 2
	},
/turf/open/floor/iron/dark/diagonal,
/area/shuttle/blackmarket_chevvy)
"bu" = (
/obj/machinery/atmospherics/components/unary/vent_pump/on/layer4{
	dir = 8
	},
/obj/effect/turf_decal/delivery/white,
/turf/open/floor/catwalk_floor/iron_dark,
/area/shuttle/blackmarket_chevvy)
"cL" = (
/obj/machinery/atmospherics/pipe/smart/manifold4w/supply/hidden/layer4,
/obj/machinery/atmospherics/pipe/smart/manifold4w/scrubbers/hidden/layer2,
/turf/open/floor/catwalk_floor/iron_dark,
/area/shuttle/blackmarket_chevvy)
"en" = (
/obj/effect/turf_decal/stripes/line{
	dir = 4
	},
/obj/effect/turf_decal/stripes/line{
	dir = 8
	},
/obj/structure/fans/tiny/forcefield{
	dir = 4
	},
/obj/machinery/door/poddoor{
	id = "skiffcargo"
	},
/turf/open/floor/catwalk_floor/iron_dark,
/area/shuttle/blackmarket_chevvy)
"fp" = (
/turf/closed/wall/mineral/titanium,
/area/shuttle/blackmarket_chevvy)
"jD" = (
/obj/effect/turf_decal/delivery/white,
/obj/machinery/door/airlock/external,
/obj/machinery/atmospherics/pipe/smart/manifold4w/supply/hidden/layer4,
/obj/machinery/atmospherics/pipe/smart/manifold4w/scrubbers/hidden/layer2,
/obj/effect/mapping_helpers/airlock/cyclelink_helper_multi{
	cycle_id = "skiffside"
	},
/turf/open/floor/catwalk_floor/iron_dark,
/area/shuttle/blackmarket_chevvy)
"ka" = (
/obj/machinery/atmospherics/components/unary/portables_connector/visible/layer4{
	dir = 4
	},
/obj/machinery/atmospherics/pipe/smart/manifold4w/scrubbers/hidden/layer2,
/obj/effect/turf_decal/bot_white,
/obj/machinery/portable_atmospherics/canister/air,
/turf/open/floor/catwalk_floor/iron_dark,
/area/shuttle/blackmarket_chevvy)
"nB" = (
/obj/machinery/atmospherics/pipe/smart/manifold4w/supply/hidden/layer4,
/obj/machinery/atmospherics/components/unary/vent_scrubber/on/layer2{
	dir = 8
	},
/obj/effect/turf_decal/delivery/white,
/turf/open/floor/catwalk_floor/iron_dark,
/area/shuttle/blackmarket_chevvy)
"pI" = (
/obj/structure/fluff/metalpole/end{
	dir = 4;
	pixel_x = 32
	},
/turf/closed/wall/mineral/titanium/nodiagonal,
/area/shuttle/blackmarket_chevvy)
"uW" = (
/obj/machinery/power/shuttle_engine/heater{
	dir = 8
	},
/obj/effect/turf_decal/stripes/line{
	dir = 4
	},
/obj/structure/window/reinforced/plasma/spawner/directional/east,
/obj/machinery/atmospherics/pipe/smart/manifold4w/scrubbers/hidden/layer2,
/turf/open/floor/plating/airless,
/area/shuttle/blackmarket_chevvy)
"vK" = (
/obj/effect/turf_decal/box/white/corners{
	dir = 1
	},
/obj/structure/railing{
	dir = 8
	},
/obj/structure/railing/corner/end{
	dir = 2
	},
/obj/effect/turf_decal/loading_area/white{
	dir = 1
	},
/obj/machinery/airalarm/directional/north,
/turf/open/floor/iron/dark/diagonal,
/area/shuttle/blackmarket_chevvy)
"yt" = (
/obj/machinery/atmospherics/components/unary/vent_pump/on/layer4{
	dir = 8
	},
/obj/machinery/button/door/directional/south{
	id = "skiffcargo";
	name = "Blast Door Control"
	},
/obj/effect/decal/cleanable/dirt,
/obj/machinery/computer/shuttle/caravan/blackmarket_chevvy{
	dir = 8
	},
/obj/item/radio/intercom/directional/north,
/turf/open/floor/iron/dark/herringbone,
/area/shuttle/blackmarket_chevvy)
"zi" = (
/obj/effect/turf_decal/stripes/line{
	dir = 8
	},
/obj/machinery/atmospherics/components/unary/passive_vent/layer2{
	dir = 4
	},
/obj/structure/fluff/metalpole/end{
	dir = 8;
	pixel_x = -32
	},
/obj/machinery/power/shuttle_engine/propulsion{
	dir = 8
	},
/turf/open/floor/plating/airless,
/area/shuttle/blackmarket_chevvy)
"zH" = (
/obj/machinery/button/door/directional/north{
	id = "skiffexts";
	name = "External Airlock Bolt Control";
	normaldoorcontrol = 1;
	specialfunctions = 4
	},
/obj/machinery/atmospherics/pipe/smart/manifold4w/supply/hidden/layer4,
/obj/machinery/atmospherics/pipe/smart/manifold4w/scrubbers/hidden/layer2,
/turf/open/floor/catwalk_floor/iron_dark,
/area/shuttle/blackmarket_chevvy)
"Dx" = (
/obj/effect/spawner/structure/window/reinforced/shuttle,
/obj/machinery/door/poddoor/shutters/preopen{
	id = "skiffwinds";
	dir = 4
	},
/turf/open/floor/plating,
/area/shuttle/blackmarket_chevvy)
"Ee" = (
/obj/machinery/atmospherics/pipe/smart/manifold4w/supply/hidden/layer4,
/obj/machinery/atmospherics/components/unary/vent_scrubber/on/layer2{
	dir = 8
	},
/obj/effect/decal/cleanable/dirt,
/obj/machinery/light/dim/directional/south,
/obj/structure/chair/comfy/shuttle{
	dir = 4
	},
/obj/machinery/button/door/directional/south{
	id = "skiffwindf";
	name = "Window Shutter Control"
	},
/turf/open/floor/iron/dark,
/area/shuttle/blackmarket_chevvy)
"Fr" = (
/obj/structure/closet/secure_closet/wall,
/turf/closed/wall/mineral/titanium/nodiagonal,
/area/shuttle/blackmarket_chevvy)
"Fu" = (
/obj/effect/turf_decal/caution/stand_clear/white{
	dir = 1
	},
/turf/open/floor/iron/dark/diagonal,
/area/shuttle/blackmarket_chevvy)
"GO" = (
/obj/effect/spawner/structure/window/reinforced/shuttle,
/obj/machinery/door/poddoor/shutters/preopen{
	id = "skiffwinds"
	},
/turf/open/floor/plating,
/area/shuttle/blackmarket_chevvy)
"Ii" = (
/obj/machinery/atmospherics/pipe/smart/manifold4w/supply/hidden/layer4,
/obj/machinery/atmospherics/pipe/smart/manifold4w/scrubbers/hidden/layer2,
/obj/machinery/light/dim/directional/south,
/turf/open/floor/catwalk_floor/iron_dark,
/area/shuttle/blackmarket_chevvy)
"JW" = (
/obj/machinery/atmospherics/pipe/smart/manifold4w/scrubbers/hidden/layer2,
/obj/machinery/button/door/directional/north{
	id = "skiffwinds";
	name = "Window Shutter Control"
	},
/obj/structure/chair/sofa/bench/left{
	dir = 4;
	pixel_y = 0;
	pixel_x = -8
	},
/turf/open/floor/iron/dark,
/area/shuttle/blackmarket_chevvy)
"Ov" = (
/turf/template_noop,
/area/template_noop)
"OB" = (
/obj/effect/turf_decal/stripes/line{
	dir = 4
	},
/obj/effect/turf_decal/stripes/line{
	dir = 8
	},
/obj/structure/fans/tiny/forcefield{
	dir = 4
	},
/obj/machinery/door/poddoor{
	id = "skiffcargo"
	},
/obj/structure/fluff/metalpole/end{
	dir = 4;
	pixel_x = 32
	},
/turf/open/floor/iron/dark,
/area/shuttle/blackmarket_chevvy)
"OR" = (
/obj/machinery/atmospherics/components/unary/vent_pump/on/layer4{
	dir = 4
	},
/obj/structure/chair/sofa/bench/right{
	dir = 4;
	pixel_x = -8
	},
/turf/open/floor/iron/dark,
/area/shuttle/blackmarket_chevvy)
"RN" = (
/obj/machinery/computer/camera_advanced/shuttle_docker/blackmarket_chevvy,
/obj/effect/turf_decal/bot_white,
/obj/structure/window/reinforced/plasma/spawner/directional/north,
/obj/effect/decal/cleanable/dirt,
/obj/machinery/airalarm/directional/west,
/turf/open/floor/iron/dark/smooth_large,
/area/shuttle/blackmarket_chevvy)
"SY" = (
/obj/effect/spawner/structure/window/reinforced/shuttle,
/obj/machinery/door/poddoor/shutters/preopen{
	id = "skiffwindf";
	dir = 8
	},
/turf/open/floor/plating,
/area/shuttle/blackmarket_chevvy)
"Tk" = (
/obj/machinery/atmospherics/components/unary/vent_scrubber/on/layer2,
/obj/structure/chair/sofa/bench/solo{
	dir = 8;
	pixel_x = 8
	},
/turf/open/floor/iron/dark,
/area/shuttle/blackmarket_chevvy)
"Vy" = (
/obj/machinery/atmospherics/pipe/smart/manifold4w/scrubbers/hidden/layer2,
/obj/structure/chair/sofa/bench{
	dir = 4;
	pixel_x = -8
	},
/turf/open/floor/catwalk_floor/iron_dark,
/area/shuttle/blackmarket_chevvy)
"Yg" = (
/obj/machinery/atmospherics/pipe/smart/manifold4w/supply/hidden/layer4,
/obj/machinery/atmospherics/pipe/smart/manifold4w/scrubbers/hidden/layer2,
/obj/effect/turf_decal/delivery/white,
/turf/open/floor/catwalk_floor/iron_dark,
/area/shuttle/blackmarket_chevvy)
"YP" = (
/obj/effect/turf_decal/box/white/corners{
	dir = 8
	},
/obj/effect/turf_decal/loading_area/white{
	dir = 2
	},
/obj/structure/railing/corner/end/flip{
	dir = 1
	},
/obj/structure/railing{
	dir = 8
	},
/obj/machinery/cell_charger_multi/wall_mounted/directional/south,
/turf/open/floor/iron/dark/diagonal,
/area/shuttle/blackmarket_chevvy)
"YX" = (
/turf/closed/wall/mineral/titanium/nodiagonal,
/area/shuttle/blackmarket_chevvy)
"ZC" = (
/obj/effect/turf_decal/caution/stand_clear/white,
/turf/open/floor/iron/dark/diagonal,
/area/shuttle/blackmarket_chevvy)
"ZE" = (
/obj/effect/turf_decal/box/white/corners{
	dir = 4
	},
/obj/machinery/button/door/directional/north{
	id = "skiffcargo";
	name = "Blast Door Control"
	},
/obj/effect/turf_decal/loading_area/white{
	dir = 1
	},
/turf/open/floor/iron/dark/diagonal,
/area/shuttle/blackmarket_chevvy)
"ZW" = (
/obj/docking_port/mobile{
	launch_status = 0;
	name = "Chevvy";
	port_direction = 4;
	preferred_direction = 8;
	shuttle_id = "blackmarket_chevvy"
	},
/obj/machinery/door/airlock/external{
	id_tag = "skiffexts"
	},
/obj/effect/turf_decal/delivery/white,
/obj/effect/mapping_helpers/airlock/cyclelink_helper_multi{
	cycle_id = "skiffside"
	},
/obj/structure/fans/tiny/forcefield,
/turf/open/floor/catwalk_floor/iron_dark,
/area/shuttle/blackmarket_chevvy)

(1,1,1) = {"
Ov
Ov
Ov
Ov
Ov
Ov
Ov
"}
(2,1,1) = {"
fp
zi
YX
Ov
YX
zi
fp
"}
(3,1,1) = {"
YX
uW
Fr
Dx
YX
uW
YX
"}
(4,1,1) = {"
YX
JW
Vy
OR
Fr
ka
YX
"}
(5,1,1) = {"
GO
Tk
cL
cL
jD
Ii
YX
"}
(6,1,1) = {"
YX
vK
Yg
YP
YX
zH
ZW
"}
(7,1,1) = {"
YX
Fu
nB
ZC
YX
jD
YX
"}
(8,1,1) = {"
YX
ZE
bu
ad
RN
Ee
YX
"}
(9,1,1) = {"
YX
OB
en
OB
YX
yt
YX
"}
(10,1,1) = {"
Ov
Ov
Ov
Ov
fp
SY
pI
"}
(11,1,1) = {"
Ov
Ov
Ov
Ov
Ov
Ov
Ov
"}
